# from /flags url path in prometheus GUI

--alertmanager.notification-queue-capacity	10000
--alertmanager.timeout	
--config.file	/etc/prometheus/config_out/prometheus.env.yaml
--enable-feature	
--log.format	logfmt
--log.level	info
--query.lookback-delta	5m
--query.max-concurrency	20
--query.max-samples	50000000
--query.timeout	2m
--rules.alert.for-grace-period	10m
--rules.alert.for-outage-tolerance	1h
--rules.alert.resend-delay	1m
--scrape.adjust-timestamps	true
--scrape.discovery-reload-interval	5s
--scrape.timestamp-tolerance	2ms
--storage.agent.no-lockfile	false
--storage.agent.path	data-agent/
--storage.agent.retention.max-time	0s
--storage.agent.retention.min-time	0s
--storage.agent.wal-compression	true
--storage.agent.wal-segment-size	0B
--storage.agent.wal-truncate-frequency	0s
--storage.remote.flush-deadline	1m
--storage.remote.read-concurrent-limit	10
--storage.remote.read-max-bytes-in-frame	1048576
--storage.remote.read-sample-limit	50000000
--storage.tsdb.allow-overlapping-blocks	true
--storage.tsdb.head-chunks-write-queue-size	0
--storage.tsdb.max-block-chunk-segment-size	0B
--storage.tsdb.max-block-duration	2h24m
--storage.tsdb.min-block-duration	2h
--storage.tsdb.no-lockfile	false
--storage.tsdb.path	/prometheus
--storage.tsdb.retention	0s
--storage.tsdb.retention.size	0B
--storage.tsdb.retention.time	1d
--storage.tsdb.wal-compression	true
--storage.tsdb.wal-segment-size	0B
--web.config.file	/etc/prometheus/web_config/web-config.yaml
--web.console.libraries	/etc/prometheus/console_libraries
--web.console.templates	/etc/prometheus/consoles
--web.cors.origin	.*
--web.enable-admin-api	false
--web.enable-lifecycle	true
--web.enable-remote-write-receiver	false
--web.external-url	
--web.listen-address	0.0.0.0:9090
--web.max-connections	512
--web.page-title	Prometheus Time Series Collection and Processing Server
--web.read-timeout	5m
--web.route-prefix	/
--web.user-assets	
